_______________________________________________
____________________________S1SS_______________
_________________________SSSSSSSSSSS___________
______AAAAAAA__________SSSSSASAAAASSS__________
______AAAAAAA_S_______SSSSSA_SooooSSSSS________
____S_SoooooS_S______SAAAAS_SSoo!oSAASS________
____S_SoooooS_S______SooooSSSSSSSSS__SAA_______
____S_Soo!oo2_SSA___ASoo!oSSSSSSSSSSSS__S______
____S_MSSSSSS_SA_SRS_SSSSSSSSSSSSSSSSSSSSS_____
____S____S____S_SSRSSSSSSSSSSRRRRSSSSSSSSS_____
____SSASSSSSSSSSSSRRRSSSSSSSRRRRRRSSSAAAASS____
____SS_SSSSSSSSSSSSSSSSSSSSSRRRRRRSSSooooSS____
___SSSSSSSSSSSSSSSSSRSSSRSSSSPRRRSSSSooooSS____
___SSSSSAAAASSSSSSSSRSSSSSSSSSSSSSSSSSSSSSS ___
___SSAAAA__SSAAAAAASRRSSSAAAAASSASSSSSSSSSAA___
____SS__SSSSSSooooSSARRRS__oooSS_SSSSSSSSS_____
____SAAAAAAASSo!ooAA__SRRRSoooSSSSSSSAASSSSS___
____SSoooooSSSSSSSS_SSSSSRSSSSSSSSSSS__SSSSS___
____SSoooooSSAAAASSSSSSSSSSSSSSSSSAASSSASSSS___
___SSSoooooSSS__AAASSSSSSRSSASSSSS__SSS_SSAA___
___SSSSSSSSSSS_P__SASAAASRRS_SS______S_________
____SSSSSSSSSAASSSS_SoooSSRSS________S_________
______SSSASSS__SSSSSSoooSSRS_________S_________
_______SS_SSSSSSAAASSSSSAAR__________S_________
_________SSSSSSSoooSAAAS__R_____WSS_SSSS_______
____________S__SoooSoooSSSR___ASSSSSSSSS_______
___________SSS_SSSSSoooSSARRRSAASSRRRRRSSS_____
___________SS__SSSSSSSSSS___RS__SRRRRRRRSS_____
___________SS____SSASSSSSS__RRRSRRRRRRRRRSS____
___________SS_____S_S________SRRRRRRRRRRRSA____
_________33333_______________SSRRRRRRRRRRS_S___
________333333333_____________S_SRRRRRRRSSSS___
_______33AA333333______________S__RRRRSSSS_____
______333__333333______________SS__SSSASSSS____
______33A33333333_______________SSSSSS_SS______
______S__SSSSSS_____________________SSSSS______
________SSSSSSSS_______________________________
________SSSSSSS________________________________
___________S___________________________________
___________S___________________________________
_______________________________________________
