XXXXXXXXXXXXXXXXXXXXXXXXXXXXXXXXXXXXXXXXXXXXXXXXXXXX
XXXXXXXXXXXXXXXXXXXXXXXXXXXXXXXXXXXXXXXXXXXXXXXXXXXX
XXXXXXXXXXXXXXXXXXXXXXXXXXXXXXXXXXXXXXXXXXXXXXXXXXXX
XXXXXXXXXXXXXXXXXXXXXXXXXXXXXXXSDDDSSXXXXXXXXXXXXXXX
XXXXXXXXXXXXXXXXXXXXXXXXXXXXXXSSSSSSXXXXXXXXXXXXXXXX
XXXXXXXXXXXXXXXXXXXXXXXXXXXXXSSSSSSSXXXXXXXXXXXXXXXX
XXXXXXXXXXXXXXXXXXXXXXXXXXXSSSSXXXXSSSSXXXXXXXXXXXXX
XXXXXXXXXXXXXXXXXXXXXXXXXXXSSSSXXXXSSXSXXXXXXXXXXXXX
XXXXXXXXXXXXXXXXXXXXXXXXXXXSSSSXXXXSXXSXXXXXXXXXXXXX
XXXXXXXXXXXXXXXXXXXXXXXXXXXSSSSXXXXSSSSXXXXXXXXXXXXX
XXXXXXXXXXXXXXXXXXXXXXXXXXSSSSSXXXSSSSSXXXXXXXXXXXXX
XXXXXXXXXXXXXXXXXXXXSSSXXXSSSSSXXSSSSXXXXXXXXXXXXXXX
XXXXXXXXXXXXXXSSSSSSSSSXXXSSXXSSXSXSXXXXXXXXXXXXXXXX
XXXXXXXXXXXXXXXSSSSSSSSXXXSXXXXSSSSSSXXXXXXXXXXXXXXX
XXXXXXXXXXXXXXSSSSSSSSSXXSSXXXSSSSSXXSSSSSSSXXXXXXXX
XXXXXXXXXXXXSSSXXXXXXSSXXSSXXXXSXXXXXSSSSSSSSSXXXXXX
XXXXXXXXXXXSSSXXXXXXXSSSSSSXXXSSSXXXXXSXXXSSSXXXXXXX
XXXXXXXXXXXSSSXXXXXXXSSSSSSSXXXXXXXXXXSXXXSSSXXXXXXX
XXXXXXXXXXXXSSXXXXXXXXXSSSXXXXXXXXXXXSSXXXXSXXXXXXXX
XXXXXXXXXXXSSSXXXXXXXXXXXSXXXXXXSSSSSSSXXXXSSSXXXXXX
XXXXXXXXXXXXXSSSSXXXXXXXXXXXXXXSSSSSSSSXXXXXSSSXXXXX
XXXXXXXXXXXSSSSSSSXXXXXXXXXXXXSSSXSSSXSXXXSSSSSSXXXX
XXXXXXXXXXXXSXXXXSXXXXXXXXXXXXSXXXXSSSSSSSSXSSSXXXXX
XXXXXXXXXXXXSXXXXSXXXXXXXXXXXXSXXXXXSSSSSSSSSSSXXXXX
XXXXXXXXSSSSSXXXXSSSXXXXXXXXXSSSSXXXSSSSSSSSSSXXXXXX
XXXXXXXXSSXXSSXXXSSSXXXXXXXXXSSSSSSXXSSSXXSSSXXXXXXX
XXXXXXXSSXXXXSSSSSSSSXXXXXSSSSSSSSSSXXXXXXXXXXXXXXXX
XXXXXXXSSXXXSSSSSSSSSSSXXXSSSSSSXSSXXXXXXXXXXXXXXXXX
XXXXXXXSSXXXXSSSSSXXXSSXXXSXSXXXSSXXXXXXXXXXXXXXXXXX
XXXXXXXSSSXXSSSXXXXXXXSSXSSXSXXXXXXXXXXXXXXXXXXXXXXX
XXXXXXXXSXXXSSSXXXXXXXSSSSSSSXXXXXXXXXXXXXXXXXXXXXXX
XXXXXXXXXXXXSSSXXXXXXXXSSSSSSXXXXXXXXXXXXXXXXXXXXXXX
XXXXXXXXXXXXXXXXXXXXXXXXXXXSSXXXXSXXXXXXXXXXXXXXXXXX
XXXXXXXXXXXXXXXXXXXXXXXXXXXXSXXXSSXSSXXXXXXXXXXXXXXX
XXXXXXXXXXXXXXXXXXXXXXXXXXXSSSSSSSSSSXXXXXXXXXXXXXXX
XXXXXXXXXXXXXXXXXXXXXXXXXXSSSSSSSSSSXXXXXXXXXXXXXXXX
XXXXXXXXXXXXXXXXXXXXXXXXXXXSSSSSSXXXXXXXXXXXXXXXXXXX
XXXXXXXXXXXXXXXXXXXXXXXXXXXXXXSSXXXXXXXXXXXXXXXXXXXX
XXXXXXXXXXXXXXXXXXXXXXXXXXXXXXSSXXXXXXXXXXXXXXXXXXXX
XXXXXXXXXXXXXXXXXXXXXXXXXXXXXXSSXXXXXXXXXXXXXXXXXXXX
XXXXXXXXXXXXXXXXXXXXXXXXXXXXXXSSXXXXXXXXXXXXXXXXXXXX
XXXXXXXXXXXXXXXXXXXXXXXXXXXXXXKKXXXXXXXXXXXXXXXXXXXX
XXXXXXXXXXXXXXXXXXXXXXXXXXXXXXXXXXXXXXXXXXXXXXXXXXXX
